..........................................................+......
.................................................................
.................................................................
.................................................................
.................................................................
.................................................................
.................................................................
.................................................................
.................................................................
.................................................................
.................................................................
.................................................................
.................................................................
.................................................................
............................................................#....
........................................................#...#....
........................................................#.#.#....
........................................................#.#.#.#..
......................................................#.#.#.#.#..
......................................................#.#.#.#.#..
......................................................#.#.#.#.#..
......................................................#.#.#.#.#..
....................................................#.#.#.#.#.#..
....................................................###########..
.................................................................
.................................................................
..............................................#.#.#.#.....#......
..............................................#.#.#.#.....#......
..............................................#.#.#.#.#...#......
..............................................#.#.#.#.#...#......
..............................................#.#.#.#.#...#......
..........................................#.#.#.#.#.#.#...#......
..........................................#.#.#.#.#.#.#...#......
..........................................#.#.#.#.#.#.#.#.#......
..........................................#.#.#.#.#.#.#.#.#......
..........................................#.#.#.#.#.#.#.#.#......
..........................................#################......
.................................................................
.................................................................
.................................................................
...............................#.................#...............
...............................###################...............
.................................................................
.................................................................
............................#####................................
.................................................................
.................................................................
.........................#####.#####.............................
.................................................................
.................................................................
......................#####.#####.#####..........................
.................................................................
.................................................................
...................#####.........................................
.................................................................
................#####.#####......................................
.................................................................
.............#####.#####.#####...................................
.................................................................
.................................................................
.................................................................
.................................................................
.................................................................
.................................................................
...............................#.................................
...............................#.................................
...............................#.................................
...............................#.................................
.............................#.#.................................
...........................#.#.#.................................
...........................#####.................................
.................................................................
..................#................#.............................
..................##################.............................
.................................................................
.................................................................
.................................#....#..........................
.................................#....#..........................
.................................#....#..........................
.................................#....#..........................
................................##....######.....................
................................#..........#.....................
................................#..........#.....................
................................#..........#.....................
................................#..........#.....................
................................#..........#.....................
................................############.....................
.................................................................
.................................................................
..........................................#..#...................
..........................................#..#...................
..........................................#..#...................
........................................###..###.................
........................................#......#.................
........................................#......#.................
........................................#......#.................
........................................#......#.................
........................................#......#.................
........................................#......#.................
........................................#......#.................
........................................########.................
.................................................................
.................................................................
..............................................#....#.............
..............................................#....#.............
..............................................#....#.............
..............................................#....#.............
.............................................##....##............
.............................................#......#............
.............................................#......#............
.............................................#......#............
.............................................########............
.................................................................
.................................................................
....................................................#............
....................................#################............
.................................................................
.................................................................
.................................................................
..............................#.......#..........................
..............................#########..........................
.................................................................
.................................................................
..............................#.....#.......#....................
..............................#.....#.......#....................
..............................#.....#.......#.#..................
..............................#.....#.......#.#..................
..............................#.....#.......#.#..................
..............................#.....#.......#.#..................
..............................#.....#.......#.#..................
..............................#.....#.#.....#.#..................
..............................#.#...#.#.#...#.#..................
..............................#.#.#.#.#.#.#.#.#..................
..............................#################..................
.................................................................
.................................................................
............................#...#................................
............................#...#................................
......................#######...#######..........................
......................#...............#..........................
......................#...............#..........................
......................#...............#..........................
......................#...............#..........................
......................#...............#..........................
......................#...............#..........................
......................#################..........................
.................................................................
.................................................................
..................######.........................................
.................................................................
...............######.######.....................................
.................................................................
............######.######.######.................................
.................................................................
.................................................................
........######...................................................
.................................................................
.................................................................
.....######.######...............................................
.................................................................
.................................................................
..######.######.######...........................................
.................................................................
.................................................................
