...........................................................
...........................................................
...........................................................
...........................................................
...........................................................
...........................................................
...........................................................
...........................................................
...........................................................
...........................................................
...........................................................
...........................................................
...........................................................
...........................................................
.....................................................#.....
.................................................#...#.....
.................................................#.#.#.....
.................................................#.#.#.#...
...............................................#.#.#.#.#...
...............................................#.#.#.#.#...
...............................................#.#.#.#.#...
...............................................#.#.#.#.#...
.............................................#.#.#.#.#.#...
.............................................###########...
...........................................................
...........................................................
.......................................#.#.#.#.....#.......
.......................................#.#.#.#.....#.......
.......................................#.#.#.#.#...#.......
.......................................#.#.#.#.#...#.......
.......................................#.#.#.#.#...#.......
...................................#.#.#.#.#.#.#...#.......
...................................#.#.#.#.#.#.#...#.......
...................................#.#.#.#.#.#.#.#.#.......
...................................#.#.#.#.#.#.#.#.#.......
...................................#.#.#.#.#.#.#.#.#.......
...................................#################.......
...........................................................
...........................................................
...........................................................
........................#..................................
........................###################................
...........................................................
...........................................................
.....................#####.................................
...........................................................
...........................................................
..................#####.#####..............................
...........................................................
...........................................................
...............#####.#####.#####...........................
...........................................................
...........................................................
............#####..........................................
...........................................................
.........#####.#####.......................................
...........................................................
......#####.#####.#####....................................
...........................................................
...........................................................
...........................................................
...........................................................
...........................................................
...........................................................
........................#..................................
........................#..................................
........................#..................................
........................#..................................
......................#.#..................................
....................#.#.#..................................
....................#####..................................
...........................................................
...........#...............................................
...........##################..............................
...........................................................
...........................................................
..........................#................................
..........................#................................
..........................#................................
..........................#................................
.........................##................................
.........................#.................................
.........................#.................................
.........................#.................................
.........................#.................................
.........................#.................................
.........................############......................
...........................................................
...........................................................
...................................#.......................
...................................#.......................
...................................#.......................
.................................#.#.......................
.................................#.........................
.................................#.........................
.................................#.........................
.................................#.........................
.................................#.........................
.................................#.........................
.................................#.........................
.................................########..................
...........................................................
...........................................................
.......................................#...................
.......................................#...................
.......................................#...................
.......................................#...................
......................................##...................
......................................#....................
......................................#....................
......................................#....................
......................................########.............
...........................................................
...........................................................
...........................................................
.............................#################.............
...........................................................
...........................................................
...........................................................
.......................#...................................
.......................#########...........................
...........................................................
...........................................................
.......................#.....#.......#.....................
.......................#.....#.......#.....................
.......................#.....#.......#.#...................
.......................#.....#.......#.#...................
.......................#.....#.......#.#...................
.......................#.....#.......#.#...................
.......................#.....#.......#.#...................
.......................#.....#.#.....#.#...................
.......................#.#...#.#.#...#.#...................
.......................#.#.#.#.#.#.#.#.#...................
.......................#################...................
...........................................................
...........................................................
.....................#.....................................
.....................#.....................................
...............#.....#.....................................
...............#...........................................
...............#...........................................
...............#...........................................
...............#...........................................
...............#...........................................
...............#...........................................
...............#################...........................
...........................................................
...........................................................
...........######..........................................
...........................................................
........######.######......................................
...........................................................
.....######.######.######..................................
...........................................................
...........................................................
.######....................................................
...........................................................
...........................................................
.....######................................................
...........................................................
...........................................................
..######.######............................................
...........................................................
